abc = asdfasdfafsa sadfasdfaf
aheap = aheap (aheap)
annexation = sát nhập
asdfsf = asdfsfafd sadfsdafaf
ashake = ashake (định hình)
bargeman = bargeman (người sà lan)
blight = bệnh bạc lá
bulbous = củ hành
catcher = Bắt
civic = Civic
composedness = sáng tác
corticate = corticate (corticate)
dampy = ẩm ướt
derogation = xúc phạm
dismalness = ảm đạm
drudgingly = drudgingly (drudgingly)
emit = phát ra
euphonious = euphonious (giả mạo)
farouche = Fierce
flannelette = bánh flannelette
free-hand = tự do
geyser = Geyser
grub-hoe = grub-cuốc
hen-coop = chuồng gà mái
humidify = làm ẩm
imperviable = không thể cản trở
inexpugnable = Bất khả xâm phạm
interpretability = khả năng diễn giải
joint-heir = đồng thừa kế
largely = Chủ yếu
liven = liven (sống động)
mantilla = Mantilla (mantilla)
mineralize = khoáng hóa
muscle = Cơ
normally = Bình thường
ophthalmitis = viêm nhãn khoa
overture = Overture
pearl-fishery = ngọc trai-thủy sản
pie-dog = pie-chó
pontoon = Pontoon
producible = có thể sản xuất
quadruplicate = bốn lần
recuperator = phục hồi sức khỏe
rhonchus = hình thoi
sand-bar = thanh cát
secessionist = người ly khai
shaving-horse = cạo râu-ngựa
slab-sided = mặt tấm
soup maigre = súp nạc
stalking-horse = rình rập-ngựa
studious = hiếu học
swankiness = thiên nga
tendon = Gân
torn = Rách
twang = twang (twang)
unemotional = Unemotional
unscourged = không được phẫu thuật
vermiculation = vermiculation (vermiculation)
week-day = ngày trong tuần
yester-eve = Yeahter-eve (đêm trước)
